ashab - musliman koji je dolazio u kontakt sa Muhammedom Bejtu-l-makdis - Jerusalim; džamija u Jerusalimu

Berzah - boravište duša od smrti do proživljenja (zagrobni život) bint - kćerka

da‘if - slab džubbe - ogrtač

ehli-kitabije - Jevreji i kršćani

Ehlu-s-sunneh we-l-džema‘ati - Sljedbenici sunneta i zajednice muslimana, najispravnija i najbrojnija grupacija muslimana

gajb - nepoznato, ljudskom umu nedokučivo garib - neobičan, nejasan

hafiz - osoba najvećeg stepena stručnosti u hadiskoj nauci hasen - dobar

hawarijjuni - učenici Isaa ibn - sin

israilijjati - predaje od jevreja i kršćana

Levhu-l-mahfuz - “Čuvana ploča”, u kojoj je unaprijed zapisano sve što će se desiti

mewkuf - predaja koja se veže za nekog od ashaba

mu‘džiza - nadnaravno djelo koje su mogli samo poslanici, a.s., uraditi uz Allahovu pomoć.

mufessir - tumač Kur’ana

munkati‘ - predaja čiji sened nije potpuno povezan mursel - hadis u čijem je senedu ispušten ashab ravvija - prenosilac predaje ili hadisa

sahih - vjerodostojan

sened - lanac prenosilaca

suhufi - manje objave poslanicima sunen - vrsta zbirke hadisa

šefa‘at - zauzimanje za nekog na Ahiretu

tabi‘in - musliman koji je dolazio u kontakt sa ashabom tavvaf - kruženje oko Ka‘be

tefsir - tumačenje Kur’ana

telbijja - zikr vezan za hadždž i umru ummet - svi sljedbenici nekog od poslanika

sallallahu alejhi ve sellem - neka je Allahov mir i spas na njega

alejhis selam - neka je mir na njega

azze we džel - Uzvišeni

subhanehu we te‘ala - Slavljen i Uzvišen neka je Allah & (dželle dželaluhu) - Uzvišeni Allah




SKRAĆENICE



dž.š. – dželle šanuhu

s.a.v.s. – salallahu alejhi ve sellem

a.s. – alejhi selam

s.v.t. – subhanehu ve te’ala